%%%%%%%%%%%%%%%%%%%
%.....      .   G %
%.%%%%%%%%%%%%%%%%%
%                 %
%. ooo            %
% oP              %
%%%%%%%%%%%%%%%%%%%%
